NO ./textures/wingn.xpm
SO ./textures/wings.xpm
WE ./textures/wingw.xpm
EA ./textures/winge.xpm

C 0, 0, 0
F 54, 56, 62


                     111
                    10001
                    10001
                    10001
                    10001
                   1000001
                   1000001
                   1000001
                   1000001
                   1000001
                   1000001
                   1000001
                   1000001
                   1000001
  1                100N001                1
 101               1000001               101
 101              100111001              101
10001             1011 1101             10001
 101              101   101              101
 101              101   101              101
 101              101   101              101
 101              101   101              101
 101              101   101              101
 101          11111011111011111          101
100011111111111000000000000000111111111110001
101000000000001000000111000000100000000000101
100000000000001000101111101000100000000000001
100000000000001000101111101000100000000000001
100000000000001000101111101000100000000000001
100000000000000000101111101000000000000000001
100000011000001000101111101000100000110000001
100000001000001000101111101000100000100000001
 1111110100000110010111110100110000010111111
       1111000010000000000000100001111
           11111000111111100011111
               1001       1001
               1001       1001
               1111       1111
