NO ./textures/wingn.xpm
SO ./textures/wings.xpm
WE ./textures/wingw.xpm
EA ./textures/winge.xpm

C 0, 0, 0
F 54, 56, 62


                     111
                    11011
                    10001
                    10001
                    10001
                   1100011
                   1000001
                   1000001
                   1000001
                   1000001
                   1000001
                   1000001
                   1000001
                   1000001
                   1000001
  1                100N001                1
 111               1000001               111
 101              100111001              101
11011             1011 1101             11011
 101              101   101              101
 101              101   101              101
 101              101   101              101
 101              101   101              101
 101              101   101              101
11011         11111011111011111         11011
100011111111111000000000000000111111111110001
101000000000001000000111000000100000000000101
100000000000001000101111101000100000000000001
100000000000001000101111101000100000000000001
100000000000001000101111101000100000000000001
100000000000000000101111101000000000000000001
100000011000001000101111101000100000110000001
110000001000001000101111101000100000100000011
 1111111100000110010111110100110000011111111
       1111100010000000000000100011111
           11111001111111110011111
               1001       1001
               1001       1001
               1111       1111
